#-SMB-1-3-CREATIVE-tilemap
#-By-rYAN pIERCE
#-Tiles:
#-(A-Z)-Stationary-Tiles
#-(0-9)-Actors
~4
-----------------------------------------------------------------------------------------------------------------------------------------------------------------------------------------------------------------
------------------------------------------------------------------------------------------------------------------------------------------------------------------------------------------------S-----------------
------------1111111111111111111111111111111111-------------------------BBBBBBB----HH------HH-----QQ-------BB-----BB-----------------------------------------------------------------------------P-----------------
------------11111111111111111111111111111111--Q------Q-----------------BB----BB----HH----HH-----QQQQ------BBB----BB-----------------------------------------------------------------------------P----
--------------------------Q----------------------------Q---------------BB-----BB----HH--HH------QQQQ------BBBB---BB-----------------------------------------------------------------------------P-----------------
-------------------Q--------------Q----------------------Q-------------BB----BB-----HH--HH-----QQ--QQ-----BB-BB--BB-----------------------------------------------------------------------------P-----------------
-------------Q--------1111111111--------Q------------------Q-----------BBBBBBB--------HH------QQ----QQ----BB--BB-BB-------------------------------------------------------------------HH--------P-----------------
-------------------1111111111111------Q----------------------Q---------BB----BB-------HH------QQQQQQQQ----BB--BB-BB------------------------------------------------------------------HHH--------P-----------------
---------Q-----11111111111111111----Q--------------------------Q-------BB-----BB------HH-----QQ------QQ---BB---BBBB-----------------------------------------------------------------HHHH--------P--------CCC------
-----------------------------------------------------------------Q-----BB-----BB------HH-----QQ------QQ---BB----BBB----------------------------------------------------------------HHHHH--------P--------EDM------
--------Q--Q---BQBQB----------------------IO------IO-------------------BB------BB-----HH----QQ--------QQ--BB-----BB--------------H--H----------H-----H---------BBBBBBBB-----------HHHHHH--------P-------CNNNC-----
--------------------------------------IO--KL------KL----------------------------------------------------------------------------HH--HH--------HH-----HH--------------------------HHHHHHH--------P-------DDFDD-----
-----------2----2-----------IO--------KL--KL------KL---------------------------------------------------------------------------HHH--HHH------HHH-----HHH-----IO-----------------HHHHHHHH--------P-------DDJDD-----
----------------------------KL--------KL--KL------KL--------------------------------------------------------------------------HHHH--HHHH----HHHH-----HHHH----KL----------------HHHHHHHHH--------H-------DDJDD-----
GGGGGGGGGGGGGGGGGGGGG-------GGGGGGGGGGGGGGGGGGGGGGGGGGGGGGGGGGG--GGGGGGGGGGGGGGG---GGGGGGGGGGGGGGGGGGGGGGGGGGGGGGGGGGGGGGGGGGGGGGGGGGGGGGGGGGGGG-----GGGGGGGGGGGGGGGGGGGGGGGGGGGGGGGGGGGGGGGGGGGG----GGGGGGGGGGGG
GGGGGGGGGGGGGGGGGGGGG-------GGGGGGGGGGGGGGGGGGGGGGGGGGGGGGGGGGG--GGGGGGGGGGGGGGG---GGGGGGGGGGGGGGGGGGGGGGGGGGGGGGGGGGGGGGGGGGGGGGGGGGGGGGGGGGGGG-----GGGGGGGGGGGGGGGGGGGGGGGGGGGGGGGGGGGGGGGGGGGG----GGGGGGGGGGGG