#-SMB-1-1-reproduction-tilemap
#-By-Dean-Antel
#-Tiles:
#-(A-Z)-Stationary-Tiles
#-(0-9)-Actors
A--------------------------------------------------------------------------------------------------------------------------------------------------------------------------------------------------------------------
A--------------------------------------------------------------------------------------------------------------------------------------------------------------------------------------------------------------------
A--------------------------------------------------------------------------------------------------------------------------------------------------------------------------------------------------------------------
A--------------------------------------------------------------------------------------------------------------------------------------------------------------------------------------------------------------------
A------------------------------------------------------------------------------------------------------------------------------------------------------------------------------------------------------S-------------
A------------------------------------------------------------------------------------------------------------------------------------------------------------------------------------------------------P-------------
A---------------------Q---------------------------------------------------------BBBBBBBB---BBBQ--------------Q-----------BBB----BQQB---------------------------------------------------------HH--------P-------------
A-------------------------------------------------------------------------------------------------------------------------------------------------------------------------------------------HHH--------P-------------
A--------QQQQ--------------------------Q---------------------------------------------------------------------------------------------------------------------------------------------------HHHH--------P----CCC------
A-----------------------------------------------------------------------------------------------------------------------------------------------------------------------------------------HHHHH--------P----EDM------
A--------QQQQQ--Q---BQBQB---------------------IO---------IO------------------BQB--------------B-----BB----Q--Q--Q-----B----------BB------H--H----------H----H------------BBQB------------HHHHHH--------P---CNNNC-----
A-------------------------------------IO------KL---------KL-----------------------------------------------------------------------------HH--HH--------HH----HH--------------------------HHHHHHH--------P---DDFDD-----
A---------------------------IO--------KL------KL---------KL----------------------------------------------------------------------------HHH--HHH------HHH----HHH-----IO--------------IO-HHHHHHHH--------P---DDJDD-----
A---------------------------KL--------KL------KL---------KL---------------------------------------------------------------------------HHHH--HHHH----HHHH----HHHH----KL--------------KLHHHHHHHHH--------H---DDJDD-----
GGGGGGGGGGGGGGGGGGGGG-------GGGGGGGGGGGGGGGGGGGGGGGGGGGGGGGGGGGGGGGGGG--GGGGGGGGGGGGGGG---GGGGGGGGGGGGGGGGGGGGGGGGGGGGGGGGGGGGGGGGGGGGGGGGGGGGGGGGGGGGGG----GGGGGGGGGGGGGGGGGGGGGGGGGGGGGGGGGGGGGGGGGGGGGGGGGGGGGGGGG
GGGGGGGGGGGGGGGGGGGGG-------GGGGGGGGGGGGGGGGGGGGGGGGGGGGGGGGGGGGGGGGPG--GGGGGGGGGGGGGGG---GGGGGGGGGGGGGGGGGGGGGGGGGGGGGGGGGGGGGGGGGGGGGGGGGGGGGGGGGGGGGG----GGGGGGGGGGGGGGGGGGGGGGGGGGGGGGGGGGGGGGGGGGGGGGGGGGGGGGGGG