#-SMB-1-1-reproduction-tilemap
#-By-Dean-Antel
#-Tiles:
#-(A-Z)-Stationary-Tiles
#-(0-9)-Actors
A-------------------------------------------------------------------------------------------------------------------------------------------------------------------------------------------------------------------
A-------------------------------------------------------------------------------------------------------------------------------------------------------------------------------------------------------------------
A-------------------------------------------------------------------------------------------------------------------------------------------------------------------------------------------------------------------
A-------------------------------------------------------------------------------------------------------------------------------------------------------------------------------------------------------------------
A-----------------------------------------------------------------------------------------------------------------------------------------------------------------------------------------------------S-------------
A-----------------------------------------------------------------------------------------------------------------------------------------------------------------------------------------------------P-------------
A---------------------Q---------------------------------------------------------BBBBBBBB---BBBQ--------------Q-----------BBB----BQQB--------------------------------------------------------HH--------P-------------
A------------------------------------------------------------------------------------------------------------------------------------------------------------------------------------------HHH--------P-------------
A-----------------------------------------------------------------------------------------------------------------------------------------------------------------------------------------HHHH--------P----CCC------
A----------------------------------------------------------------------------------------------------------------------------------------------------------------------------------------HHHHH--------P----EDM------
A---------------Q---BQBQB---------------------IO---------IO------------------BQB--------------B-----BB----Q--Q--Q-----B----------BB------H--H----------HH--H------------BBQB------------HHHHHH--------P---CNNNC-----
A-------------------------------------IO------KL---------KL-----------------------------------------------------------------------------HH--HH--------HHH--HH--------------------------HHHHHHH--------P---DDFDD-----
A---------------------------IO--------KL------KL---------KL----------------------------------------------------------------------------HHH--HHH------HHHH--HHH-----IO--------------IO-HHHHHHHH--------P---DDJDD-----
A---------------------------KL	------KL------KL---------KL---------------------------------------------------------------------------HHHH--HHHH----HHHHH--HHHH----KL--------------KLHHHHHHHHH--------H---DDJDD-----
GGGGGGGGGGGGGGGGGGGGGGGGGGGGGGGGGGGGGGGGGGGGGGGGGGGGGGGGGGGGGGGGGGGGG--GGGGGGGGGGGGGGG---GGGGGGGGGGGGGGGGGGGGGGGGGGGGGGGGGGGGGGGGGGGGGGGGGGGGGGGGGGGGGGGG--GGGGGGGGGGGGGGGGGGGGGGGGGGGGGGGGGGGGGGGGGGGGGGGGGGGGGGGGG
GGGGGGGGGGGGGGGGGGGGGGGGGGGGGGGGGGGGGGGGGGGGGGGGGGGGGGGGGGGGGGGGGGGGG--GGGGGGGGGGGGGGG---GGGGGGGGGGGGGGGGGGGGGGGGGGGGGGGGGGGGGGGGGGGGGGGGGGGGGGGGGGGGGGGG--GGGGGGGGGGGGGGGGGGGGGGGGGGGGGGGGGGGGGGGGGGGGGGGGGGGGGGGGG