#-SMB-1-1-reproduction-tilemap
#-By-Dean-Antel
#-Tiles:
#-(A-Z)-Stationary-Tiles
#-(0-9)-Actors
~0
--------------------------------------------------------------------------------------------------------------------------------------------------------------------------------------------------------------------
--------------------------------------------------------------------------------------------------------------------------------------------------------------------------------------------------------------------
--------------------------------------------------------------------------------------------------------------------------------------------------------------------------------------------------------------------
--------------------------------------------------------------------------------------------------------------------------------------------------------------------------------------------------------------------
------------------------------------------------------------------------------------------------------------------------------------------------------------------------------------------------------S-------------
------------------------------------------------------------------------------------------------------------------------------------------------------------------------------------------------------P-------------
----------------------Q---------------------------------------------------------BBBBBBBB---BBBQ--------------Q-----------BBB----BQQB--------------------------------------------------------HH--------P-------------
-------------------------------------------------------------------------------------------------------------------------------------------------------------------------------------------HHH--------P-------------
------------------------------------------------------------------------------------------------------------------------------------------------------------------------------------------HHHH--------P----CCC------
-----------------------------------------------------------------------------------------------------------------------------------------------------------------------------------------HHHHH--------P----EDM------
----------11----Q---BQBQB---------------------IO---------IO------------------BQB--------------B-----BB----Q--Q--Q-----B----------BB------H--H----------HH--H------------BBQB------------HHHHHH--------P---CNNNC-----
--------------------------------------IO------KL---------KL-----------------------------------------------------------------------------HH--HH--------HHH--HH--------------------------HHHHHHH--------P---DDFDD-----
----------------------------IO--------KL------KL---------KL----------------------------------------------------------------------------HHH--HHH------HHHH--HHH-----IO--------------IO-HHHHHHHH--------P---DDJDD-----
----------------------------KL--------KL------KL---------KL---------------------------------------------------------------------------HHHH--HHHH----HHHHH--HHHH----KL--------------KLHHHHHHHHH--------H---DDJDD-----
GGGGGGGGGGGGGGGGGGGGGGGGGGGGGGGGGGGGGGGGGGGGGGGGGGGGGGGGGGGGGGGGGGGGG--GGGGGGGGGGGGGGG---GGGGGGGGGGGGGGGGGGGGGGGGGGGGGGGGGGGGGGGGGGGGGGGGGGGGGGGGGGGGGGGG--GGGGGGGGGGGGGGGGGGGGGGGGGGGGGGGGGGGGGGGGGGGGGGGGGGGGGGGGG
GGGGGGGGGGGGGGGGGGGGGGGGGGGGGGGGGGGGGGGGGGGGGGGGGGGGGGGGGGGGGGGGGGGGG--GGGGGGGGGGGGGGG---GGGGGGGGGGGGGGGGGGGGGGGGGGGGGGGGGGGGGGGGGGGGGGGGGGGGGGGGGGGGGGGG--GGGGGGGGGGGGGGGGGGGGGGGGGGGGGGGGGGGGGGGGGGGGGGGGGGGGGGGGG