#-SMB-1-3-CREATIVE-tilemap
#-By-rYAN pIERCE
#-Tiles:
#-(A-Z)-Stationary-Tiles
#-(0-9)-Actors
~4
-----------------------------------------------------------------------------------------------------------------------------------------------------------------------------------------------------------------
-----------------------------------------------------------------------------------------------------------------------------------------------------------------------------------------------------------------
------------1111111111111111111111111111111111-------------------------BBBBBBB----11------11-----QQ-------BB11111BB----------------------------------------------------------------------------------------------
------------11111111111111111111111111111111--Q------Q-----------------BB----BB----11----11-----QQQQ------BBB1111BB----------------------------------------------------------------------------------------------
--------------------------Q----------------------------Q---------------BB-----BB----11--11------QQQQ------BBBB111BB-----------------------------------------------------------------------------S----------------
-------------------Q--------------Q----------------------Q-------------BB----BB-----11--11-----QQ--QQ-----BB-BB11BB-----------------------------------------------------------------------------P----------------
-------------Q--------1111111111--------Q------------------Q-----------BBBBBBB--------11------QQ----QQ----BB11BB1BB-------------------------------------------------------------------HH--------P----------------
-------------------1111111111111------Q----------------------Q---------BB----BB-------11------QQQQQQQQ----BB11BB1BB------------------------------------------------------------------HHH--------P----------------
---------Q-----11111111111111111----Q--------------------------Q-------BB-----BB------11-----QQ------QQ---BB111BBBB-----------------------------------------------------------------HHHH--------P----------------
-----------------------------------------------------------------Q-----BB-----BB------11-----QQ------QQ---BB1111BBB--------------------------------------------11111111------------HHHHH--------P--------CCC-----
--------Q--Q---BQBQB----------------------IO------IO-------------------BB------BB-----11----QQ--------QQ--BB11111BB--------------H--H----------H-----H---------BBBBBBBB-----------HHHHHH--------P--------EDM-----
--------------------------------------IO--KL------KL----------------------------------------------------------------------------HH--HH--------HH-----HH--------------------------HHHHHHH--------P-------CNNNC----
----------------------------IO--------KL--KL------KL---------------------------------------------------------------------------HHH--HHH------HHH-----HHH-----IO-----------------HHHHHHHH--------P-------DDJDD----
----------------------------KL--------KL--KL------KL--------------------------------------------------------------------------HHHH--HHHH----HHHH-----HHHH----KL----------------HHHHHHHHH--------H-------DDJDD----
GGGGGGGGGGGGGGGGGGGGG-------GGGGGGGGGGGGGGGGGGGGGGGGGGGGGGGGGGG--GGGGGGGGGGGGGGG---GGGGGGGGGGGGGGGGGGGGGGGGGGGGGGGGGGGGGGGGGGGGGGGGGGGGGGGGGGGGG-----GGGGGGGGGGGGGGGGGGGGGGGGGGGGGGGGGGGGGGGGGGGG----GGGGGGGGGGGG
GGGGGGGGGGGGGGGGGGGGG-------GGGGGGGGGGGGGGGGGGGGGGGGGGGGGGGGGGG--GGGGGGGGGGGGGGG---GGGGGGGGGGGGGGGGGGGGGGGGGGGGGGGGGGGGGGGGGGGGGGGGGGGGGGGGGGGGG-----GGGGGGGGGGGGGGGGGGGGGGGGGGGGGGGGGGGGGGGGGGGG----GGGGGGGGGGGG