#-SMB-1-3-CREATIVE-tilemap
#-By-rYAN pIERCE
#-Tiles:
#-(A-Z)-Stationary-Tiles
#-(0-9)-Actors
~6
-----------------------------------------------------------------------------------------------------------------------------------------------------------------------------------------------------------------
-----------------------------------------------------------------------------------------------------------------------------------------------------------------------------------------------------------------
------------1111111111111111111111111111111111-------------------------BBBBBBB----11------11-----QQ-------BB-----BB----------------------------------------------------------------------------------------------
------------11111111111111111111111111111111--Q------Q-----------------BB----BB----11----11-----QQQQ------BBB----BB----------------------------------------------------------------------------------------------
--------------------------Q----------------------------Q---------------BB-----BB----11--11------QQQQ------BBBB---BB-----------------------------------------------------------------------------S----------------
-------------------Q--------------Q----------------------Q-------------BB----BB-----11--11-----QQ--QQ-----BB-BB--BB-----------------------------------------------------------------------------P----------------
-------------Q--------1111111111--------Q------------------Q-----------BBBBBBB--------11------QQ----QQ----BB--BB-BB-------------------------------------------------------------------HH--------P----------------
-------------------1111111111111------Q----------------------Q---------BB----BB-------11------QQQQQQQQ----BB--BB-BB------------------------------------------------------------------HHH--------P----------------
---------Q-----11111111111111111----Q--------------------------Q-------BB-----BB------11-----QQ------QQ---BB---BBBB-----------------------------------------------------------------HHHH--------P----------------
-----------------------------------------------------------------Q-----BB-----BB------11-----QQ------QQ---BB----BBB----------------------------------------------------------------HHHHH--------P--------CCC-----
--------Q--Q---BQBQB----------------------IO------IO-------------------BB------BB-----11----QQ--------QQ--BB-----BB--------------H--H----------H-----H---------BBBBBBBB-----------HHHHHH--------P--------EDM-----
--------------------------------------IO--KL------KL----------------------------------------------------------------------------HH--HH--------HH-----HH--------------------------HHHHHHH--------P-------CNNNC----
-----------2----2-----------IO--------KL--KL------KL---------------------------------------------------------------------------HHH--HHH------HHH-----HHH-----IO-----------------HHHHHHHH--------P-------DDJDD----
----------------------------KL--------KL--KL------KL--------------------------------------------------------------------------HHHH--HHHH----HHHH-----HHHH----KL----------------HHHHHHHHH--------H-------DDJDD----
GGGGGGGGGGGGGGGGGGGGG-------GGGGGGGGGGGGGGGGGGGGGGGGGGGGGGGGGGG--GGGGGGGGGGGGGGG---GGGGGGGGGGGGGGGGGGGGGGGGGGGGGGGGGGGGGGGGGGGGGGGGGGGGGGGGGGGGG-----GGGGGGGGGGGGGGGGGGGGGGGGGGGGGGGGGGGGGGGGGGGG----GGGGGGGGGGGG
GGGGGGGGGGGGGGGGGGGGG-------GGGGGGGGGGGGGGGGGGGGGGGGGGGGGGGGGGG--GGGGGGGGGGGGGGG---GGGGGGGGGGGGGGGGGGGGGGGGGGGGGGGGGGGGGGGGGGGGGGGGGGGGGGGGGGGGG-----GGGGGGGGGGGGGGGGGGGGGGGGGGGGGGGGGGGGGGGGGGGG----GGGGGGGGGGGG